#
#   @            ####
#                  ##
#####   ############
#...#   #############
#   #   #####
#$$$#   #######
#   #   ##
    #   #
#        ##########
#            ########
#            #
###           #######
#####          ##
#######   ###########
#####          #