########
#   @  #
#      #
#      #
#      #
#      #
#.  $  #
########
